AAA: Arrange, Act, Assert

CRM: Customer Relationship Management

DAX: Data Analysis Expressions
DBA: Database Administrator
DDD: Domain-Driven Design
DDL: Data Definition Language
DIE: Drop if exists
DRY: Don't Repeat Yourself
DML: Data Modification Language
DMV: Dynamic Management Views

ETL: Extract, transform, and Load
ERP: Enterprise Resource Planning

GPS: Global Positioning System

HCI: Human-computer Interface
HRM: Human Resource Management
HTAP: Hybrid Transactional and Analytical Processing

IaaS: Infrastructure-as-a-Service

JSON: JavaScript Object Notation

LQS: Live Query Statistics
LTS: Long-Term Support

OData: Open Data Protocol
ODBC: Open Database Connectivity
OLE DB: Object Linking and Embedding Database
OLTP: Online Transaction Processing

PaaS: Platform as a Service
POC: Proof of Concept

RLS: Row-Level Security
RVSP: 

SaaS: Software as a Service
SKU: Stock Keeping Unit
SME: Subject Matter Expert
SRID: Spatial Reference Identifier
SSIS: SQL Server Integration Services

TDD: Test-Driven Development

XML: eXtensible Markup Language

YAML: YAML Ain't Markup Language

